1111111111111111
1111 11111111111
1111         111
1111 1111111 111
1111 1111111 111
111   111111  11
1111 1111    111
1111 111    1111
1111 111   11111
1      1  111111
1 2222 11  11 11
1 2233 111  1111
2 2233 1111  111
  2333 11 11  11
1      111111  1
1111211111111511