11111  111111 11
1              1
1      11      1
1      1 1     1
2      1  1    1
       1   1   1
1      1     111
11     1    1  1
1111   1   1   1
1      1  1    1
1 212  1       1
1  3   1       1
2   3  1       1
     3 1       1
1     31       1
11 1211111111511