1111111111111 11
1              1
1              1
1              1
1              1
1              1
1              1
1              1
1              1
1      1       1
1      1       1
1      1       1
2      1       1
               1
1      1       1
1111211111111511