11111  111111 11
1              1
1 212  1       1
1  3   1       1
2  3   1       1
     321       1
1      1       1
11     1       1
11111  1       1
1      1       1
1 212  1       1
1  3   1       1
2  33  1       1
     3 1       1
1111  31       1
11 1211111111 11