1111111111111111
1111 11111111111
1111         111
1111 1111111 111
1111 1111111 111
111   111111  11
1111 1111    111
1111 111    1111
1111 111   11111
1      1  111111
1 1112 11  11 11
1 1122 111  1111
2 1112 1111  111
  1112 11 11  11
2      111111  1
1111111111111511