1111111111111111
1              1
1  111111111   5
1        1111111
1111111   111  1
111            1
11  11111 122221
2   11111 111121
   111111 122221
2   11111 121111
11    111 122221
11111          1
111111   1111111
1111   111111  5
11111          1
1111111111111111