1111111111111111
1111111111111111
2              5
   22222  222221
2  2   2  2   21
1  22222  222221
1              1
122221  1111 111
1112211        5
122221  1111 111
1              1
1  22222  222221
2  2   2  2   21
   22222  222221
2              5
1111111111111111