11111  111111 11
1              1
1 2            1
1      1       1
2      1       1
2      1       1
1      1       1
11     1       1
11111  1       1
1      1       1
1 212  1       1
1      1       1
2      1       1
       1       1
1      1       1
11 1211111111511