1111111111112 21
1              1
1              1
1              1
1     1111111111
1     1111111111
1              1
1              1
1              1
1      111     1
1      111     1
1      111     1
2      111     1
       111     1
2      111     1
1111211111111511